#################
#       #       #
# ##### # ##### #
# #   # # #   # #
# # # # # # # # #
#   # #   # #   #
##### # ### #####
#     #   # #   #
# ########### # #
#           # # #
# ######### # # #
# #       # # # #
# # ##### # # # #
# #     #   #   #
# # # ### ### # #
# # #     #   # #
# # ##### # ### #
#A#       #     B
#################
